#cmakedefine HAVE_MALLOC_H	1
#cmakedefine HAVE_ALLOCA_H	1
#cmakedefine HAVE_ALLOCA	1
#cmakedefine HAVE_ATEXIT	1
#cmakedefine HAVE_SIGACTION	1
#cmakedefine HAVE_EXECINFO_H	1
#cmakedefine HAVE_BACKTRACE	1
#cmakedefine HAVE_MALLOC_STATS	1
#cmakedefine HAVE_MALLINFO	1
#cmakedefine HAVE_STDBOOL_H	1
#cmakedefine HAVE_SETJMP_H	1
#cmakedefine HAVE_CLOCK_GETTIME	1
#cmakedefine HAVE_SIGSETJMP	1
#cmakedefine RELAX_SIGNAL	1
#cmakedefine USE_ZLIB		1
#cmakedefine USE_LZO		1
#cmakedefine INTERP_FILE	"@INTERP_FILE@"
#cmakedefine LOG_DIR		"@LOG_DIR@"

#define __mkstr1(___a)		#___a
#define __mkstr2(___a)		__mkstr1(___a)
#define REPLAYER_ENTRY		__replayer_entry
#define REPLAYER_ENTRY_STR	__mkstr2(REPLAYER_ENTRY)

